111111111111111111111111111
100000000010000001110000001
100000000000000000E10000001
100000111000000001111000001
100000000000000000000000001
1P100000C000000000000000011
111111111111111111111111111