111111111111111111111111111111111111111111111
1000000000100000011100000000C0000000000000001
100000000000000000E10000000000000001110000001
100000111000000001111000000010000000000000001
100000000000000000000000000000000000000000001
101000000000000000000000010000000000000011101
100000000000000000000000000000000000000000001
100000C00000000000001000000000000000000000001
100000111000000000000000000000000000000C00001
10000000000001110000000000C000000000000000001
1000000000000000000000000000000000C0000000001
11100000000000C000000000000000000000001000001
100000000000000000000000000000000000000000001
10P000000000000000000000000000000000000000001
100000000000000000000000000000000011001000001
1000000000000000000000C0000000000000000000001
100000000000000000001111110000000000000000001
1000000C0000000000000000000000000000000000001
111111111111111111111111111111111111111111111